911111111111111111119
910000000010000000019
912110111010111011219
910000000000000000019
910110101111101011019
910000100010001000019
911110111010111011119
999910199989991019999
111110191131191011111
000000091567190000000
111110191111191011111
999910199999991019999
911110111010111011119
910000100010001000019
910110101111101011019
910000000040000000019
912110111010111011219
910000000010000000019
911111111111111111119