111111111111111111111
110000000010000000011
112110111010111011211
110000000000000000011
110110101111101011011
110000100010001000011
111110111010111011111
100010199989991010001
101010191131191010101
101000091567190000101
101010191111191010101
100010199999991010001
111110111010111011111
110000100010001000011
110110101111101011011
110000000040000000011
112110111010111011211
110000000010000000011
111111111111111111111